5
-6 1 6 1
-5 1 6 1
-5 1 9 1
-4 1 6 1
-3 1 6 1
